   C  67,77,77
   F     140,130,130

NO ./textures/dir_tex/north.xpm
SO ./textures/dir_tex/south.xpm
WE ./textures/dir_tex/west.xpm
EA ./textures/dir_tex/east.xpm

111111111111111111111111111111111111111111111111
100000000000000000000000000000000000000000000001
100100010001000100010001000100010001000100010001
100100010001000100010001000100010001000100010001
100100010001000100010001000100010001000100010001
100100010001000100010001000100010001000100010001
100100010001000100010001000100010001000100010001
100000000000000000000000000000000000000000000001
100000000000000000000000000000000000000000000001
100000000000000000000000000000000000000000000001
100000000000000000000000000000000000000000000001
100001111111000000000000000000000000000100000001
100000001000000000000000000000000000000100000001
100000001000000000000000000000000000000100000001
100000001000000000000000000000000000000100000001
100000001000000000000000000000000000000100000001
100000001000000000000000000000000000000100000001
100000001000000000000000000000000000000100000001
100000001000000000000000000000000000000100000001
100000001000000000000000000000000000000100000001
100000001000000000000000000000000000000100000001
100000001000000000000000000000000000000100000001
100000001000000000000000000000000000000100000001
100000001000000000000000000000000000000100000001
100000001000000000000000000000000000111111100001
100000000000000000000000000000000000000000000001
100000000000000000000000000000000000000000000001
1000000000000000000000N0000000000000000000000001
111111111111111111111111111111111111111111111111