NO ./textures/morocco_tex/north.xpm
SO ./textures/morocco_tex/south.xpm
WE ./textures/morocco_tex/west.xpm
EA ./textures/morocco_tex/east.xpm

F 250,250,200
C 119,119,100

11111111111111111111111111111111111
10000000000000000000000000000000001
10000000000000000000000000000000001
10000000000000000000000000000000001
10000000000000000000000000000000001
10000000000000000000000000000000001
10000000000000000000000000000000001
10000000000000000000000000000000001
11111111111000000000000001111111111
10000000000000000000000000000000001
10000000000010000000000010000000001
10000000000010000000000010000000001
10000000000010000000000010000000001
10000000000010000000000010000000001
10000000000010000000000010000000001
10000000000010000000000011111111101
10000000000010000000000010000000001
10000000000010000000000010000000001
100000000000100000S0000010000000001
10000000000010000000000010000000001
11111111111111111111111111111111111
